{
  "id": "l10_webex_warfare",
  "name": "Webex Warfare",
  "tier": "tier4",
  "background": "bg_stars",
  "music": "audio.level_boss_music",
  "speed": 9,
  "grid": [
    "........................................",
    "........................................",
    "...............w..............w.........",
    "........................................",
    "...........w...........w................",
    "........................................",
    ".............w..............w...........",
    "........................................",
    "....................P...................",
    "........................................",
    "...............w..............w.........",
    "........................................",
    "...........w...........w................",
    "........................................",
    ".............w..............w...........",
    "........................................",
    "........................................",
    "...............w..............w.........",
    "........................................",
    "...........w...........w................",
    "........................................",
    ".............w..............w...........",
    "........................................",
    "....................h..................."
  ],
  "waves": [
    {
      "template": "webex_wave",
      "count": 13,
      "spawn_interval": 2
    }
  ],
  "cutscenes": {
    "intro": "static/asset_packages/default/storyboard/levels/l10_intro.json",
    "outro": "static/asset_packages/default/storyboard/levels/l10_outro.json"
  }
}
