{
  "id": "l11_teams_terror",
  "name": "Teams Terror",
  "tier": "tier4",
  "background": "bg_stars",
  "music": "audio.level_boss_music",
  "speed": 9,
  "grid": [
    "........................................",
    "........................................",
    "...............t..............t.........",
    "........................................",
    "...........t...........t................",
    "........................................",
    ".............t..............t...........",
    "........................................",
    "........................................",
    "...............t..............t.........",
    "........................................",
    "...........t...........t................",
    "........................................",
    ".............t..............t...........",
    "........................................",
    "....................P...................",
    "...............t..............t.........",
    "........................................",
    "...........t...........t................",
    "........................................",
    ".............t..............t...........",
    "........................................",
    "........................................",
    "....................s..................."
  ],
  "waves": [
    {
      "template": "teams_assault",
      "count": 14,
      "spawn_interval": 2
    }
  ],
  "cutscenes": {
    "intro": "static/asset_packages/default/storyboard/levels/l11_intro.json",
    "outro": "static/asset_packages/default/storyboard/levels/l11_outro.json"
  }
}
