{
  "id": "l12_interview_inferno",
  "name": "Interview Inferno - Final Boss",
  "tier": "tier4",
  "background": "bg_stars",
  "music": "audio.level_boss_music",
  "speed": 10,
  "grid": [
    "........................................",
    "........................................",
    "...............g..............R.........",
    "........................................",
    "...........L...........a................",
    "........................................",
    ".............t..............w...........",
    "........................................",
    "....................P...................",
    "........................................",
    "...............e..............p.........",
    "........................................",
    "...........c...........g................",
    "........................................",
    ".............R..............L...........",
    "........................................",
    "........................................",
    "...............a..............t.........",
    "........................................",
    "...........w...........e................",
    "........................................",
    ".............p..............c...........",
    "........................................",
    "....................i..................."
  ],
  "waves": [
    {
      "template": "final_boss",
      "count": 15,
      "spawn_interval": 1
    }
  ],
  "cutscenes": {
    "intro": "static/asset_packages/default/storyboard/levels/l12_intro.json",
    "outro": "static/asset_packages/default/storyboard/levels/l12_outro.json"
  }
}
