{
  "id": "l1_orbital_onboarding",
  "name": "Orbital Onboarding",
  "tier": "tier1",
  "background": "bg_stars",
  "music": "audio.level_music",
  "speed": 4,
  "grid": [
    "........................................",
    "........................................",
    "...............p..............c........",
    "........................................",
    "...........w...........e................",
    "........................................",
    ".............c..............w...........",
    "........................................",
    "....................P...................",
    "........................................",
    "...............e..............c.........",
    "........................................",
    "...........w...........p................",
    "........................................",
    ".............c..............w...........",
    "........................................",
    "........................................",
    "...............e..............c.........",
    "........................................",
    "...........w...........p................",
    "........................................",
    ".............c..............w...........",
    "........................................",
    "........................................",
    "....................i..................."
  ],
  "waves": [
    {
      "template": "drift",
      "count": 3,
      "spawn_interval": 5
    }
  ],
  "cutscenes": {
    "intro": "static/asset_packages/default/storyboard/intro/intro_scene.json",
    "outro": "static/asset_packages/default/storyboard/intro/intro_scene.json"
  }
}
