{
  "id": "l2_resume_rapids",
  "name": "Resume Rapids",
  "tier": "tier1",
  "background": "bg_stars",
  "music": "audio.level_music",
  "speed": 5,
  "grid": [
    "........................................",
    "........................................",
    "...............R..............R.........",
    "........................................",
    "...........e...........p................",
    "........................................",
    ".............R..............R...........",
    "........................................",
    "........................................",
    "...............e..............p.........",
    "........................................",
    "...........R...........e................",
    "........................................",
    ".............R..............e...........",
    "........................................",
    "........................................",
    "...............R..............p.........",
    "........................................",
    "...........e...........R................",
    "........................................",
    ".............p..............R...........",
    "........................................",
    "........................................",
    "....................P..................."
  ],
  "waves": [
    {
      "template": "resume_wave",
      "count": 5,
      "spawn_interval": 4
    }
  ],
  "cutscenes": {
    "intro": "static/asset_packages/default/storyboard/levels/l2_intro.json",
    "outro": "static/asset_packages/default/storyboard/levels/l2_outro.json"
  }
}
