{
  "id": "l3_linkedin_labyrinth",
  "name": "LinkedIn Labyrinth",
  "tier": "tier1",
  "background": "bg_stars",
  "music": "audio.level_music",
  "speed": 5,
  "grid": [
    "........................................",
    "........................................",
    "...............L..............l.........",
    "........................................",
    "...........p...........e................",
    "........................................",
    ".............L..............l...........",
    "........................................",
    "....................P...................",
    "........................................",
    "...............l..............L.........",
    "........................................",
    "...........L...........e................",
    "........................................",
    ".............l..............L...........",
    "........................................",
    "........................................",
    "...............L..............l.........",
    "........................................",
    "...........e...........p................",
    "........................................",
    ".............L..............l...........",
    "........................................",
    "........................................"
  ],
  "waves": [
    {
      "template": "linkedin_patrol",
      "count": 6,
      "spawn_interval": 5
    }
  ],
  "cutscenes": {
    "intro": "static/asset_packages/default/storyboard/levels/l3_intro.json",
    "outro": "static/asset_packages/default/storyboard/levels/l3_outro.json"
  }
}
