{
  "id": "l4_application_asteroid",
  "name": "Application Asteroid",
  "tier": "tier2",
  "background": "bg_stars",
  "music": "audio.level_music",
  "speed": 6,
  "grid": [
    "........................................",
    "........................................",
    "...............a..............a.........",
    "........................................",
    "...........p...........e................",
    "........................................",
    ".............a..............c...........",
    "........................................",
    "........................................",
    "...............e..............p.........",
    "........................................",
    "...........a...........e................",
    "........................................",
    ".............a..............w...........",
    "........................................",
    "....................P...................",
    "...............a..............a.........",
    "........................................",
    "...........e...........p................",
    "........................................",
    ".............a..............c...........",
    "........................................",
    "........................................",
    "....................h..................."
  ],
  "waves": [
    {
      "template": "application_swarm",
      "count": 7,
      "spawn_interval": 4
    }
  ],
  "cutscenes": {
    "intro": "static/asset_packages/default/storyboard/levels/l4_intro.json",
    "outro": "static/asset_packages/default/storyboard/levels/l4_outro.json"
  }
}
