{
  "id": "l5_meeting_mayhem",
  "name": "Meeting Mayhem",
  "tier": "tier2",
  "background": "bg_stars",
  "music": "audio.level_music",
  "speed": 6,
  "grid": [
    "........................................",
    "........................................",
    "...............t..............z.........",
    "........................................",
    "...........w...........c................",
    "........................................",
    ".............t..............w...........",
    "........................................",
    "........................................",
    "...............z..............t.........",
    "........................................",
    "...........w...........c................",
    "........................................",
    ".............t..............z...........",
    "........................................",
    "....................P...................",
    "...............w..............c.........",
    "........................................",
    "...........t...........z................",
    "........................................",
    ".............w..............t...........",
    "........................................",
    "........................................",
    "....................s..................."
  ],
  "waves": [
    {
      "template": "meeting_chaos",
      "count": 8,
      "spawn_interval": 3
    }
  ],
  "cutscenes": {
    "intro": "static/asset_packages/default/storyboard/levels/l5_intro.json",
    "outro": "static/asset_packages/default/storyboard/levels/l5_outro.json"
  }
}
