{
  "id": "l6_chatgpt_cluster",
  "name": "ChatGPT Cluster",
  "tier": "tier2",
  "background": "bg_stars",
  "music": "audio.level_boss_music",
  "speed": 7,
  "grid": [
    "........................................",
    "........................................",
    "...............g..............g.........",
    "........................................",
    "...........e...........p................",
    "........................................",
    ".............g..............c...........",
    "........................................",
    "........................................",
    "...............e..............g.........",
    "........................................",
    "...........g...........e................",
    "........................................",
    ".............g..............w...........",
    "........................................",
    "....................P...................",
    "...............g..............g.........",
    "........................................",
    "...........p...........e................",
    "........................................",
    ".............g..............g...........",
    "........................................",
    "........................................",
    "....................W..................."
  ],
  "waves": [
    {
      "template": "ai_assault",
      "count": 9,
      "spawn_interval": 3
    }
  ],
  "cutscenes": {
    "intro": "static/asset_packages/default/storyboard/levels/l6_intro.json",
    "outro": "static/asset_packages/default/storyboard/levels/l6_outro.json"
  }
}
