{
  "id": "l7_email_onslaught",
  "name": "Email Onslaught",
  "tier": "tier3",
  "background": "bg_stars",
  "music": "audio.level_music",
  "speed": 7,
  "grid": [
    "........................................",
    "........................................",
    "...............e..............e.........",
    "........................................",
    "...........e...........e................",
    "........................................",
    ".............e..............e...........",
    "........................................",
    "....................P...................",
    "........................................",
    "...............e..............e.........",
    "........................................",
    "...........e...........e................",
    "........................................",
    ".............e..............e...........",
    "........................................",
    "........................................",
    "...............e..............e.........",
    "........................................",
    "...........e...........e................",
    "........................................",
    ".............e..............e...........",
    "........................................",
    "....................h..................."
  ],
  "waves": [
    {
      "template": "email_flood",
      "count": 10,
      "spawn_interval": 2
    }
  ],
  "cutscenes": {
    "intro": "static/asset_packages/default/storyboard/levels/l7_intro.json",
    "outro": "static/asset_packages/default/storyboard/levels/l7_outro.json"
  }
}
