{
  "id": "l8_pdf_pandemonium",
  "name": "PDF Pandemonium",
  "tier": "tier3",
  "background": "bg_stars",
  "music": "audio.level_music",
  "speed": 8,
  "grid": [
    "........................................",
    "........................................",
    "...............p..............p.........",
    "........................................",
    "...........p...........p................",
    "........................................",
    ".............p..............p...........",
    "........................................",
    "........................................",
    "...............p..............p.........",
    "........................................",
    "...........p...........p................",
    "........................................",
    ".............p..............p...........",
    "........................................",
    "....................P...................",
    "...............p..............p.........",
    "........................................",
    "...........p...........p................",
    "........................................",
    ".............p..............p...........",
    "........................................",
    "........................................",
    "....................s..................."
  ],
  "waves": [
    {
      "template": "document_deluge",
      "count": 11,
      "spawn_interval": 2
    }
  ],
  "cutscenes": {
    "intro": "static/asset_packages/default/storyboard/levels/l8_intro.json",
    "outro": "static/asset_packages/default/storyboard/levels/l8_outro.json"
  }
}
