{
  "id": "l9_phone_phalanx",
  "name": "Phone Phalanx",
  "tier": "tier3",
  "background": "bg_stars",
  "music": "audio.level_music",
  "speed": 8,
  "grid": [
    "........................................",
    "........................................",
    "...............c..............c.........",
    "........................................",
    "...........c...........c................",
    "........................................",
    ".............c..............c...........",
    "........................................",
    "........................................",
    "...............c..............c.........",
    "........................................",
    "...........c...........c................",
    "........................................",
    ".............c..............c...........",
    "........................................",
    "....................P...................",
    "...............c..............c.........",
    "........................................",
    "...........c...........c................",
    "........................................",
    ".............c..............c...........",
    "........................................",
    "........................................",
    "....................W..................."
  ],
  "waves": [
    {
      "template": "call_cascade",
      "count": 12,
      "spawn_interval": 2
    }
  ],
  "cutscenes": {
    "intro": "static/asset_packages/default/storyboard/levels/l9_intro.json",
    "outro": "static/asset_packages/default/storyboard/levels/l9_outro.json"
  }
}
